15
022220022222000
020020002000000
120020022222220
000020220002020
222020022202020
200020000200020
202220222222020
202000000002020
202222222002020
200200002002023
202200222022000
202002200020002
222002000020002
002002222222202
002220000000222
