30
022222022000002222222222222222
020002002222022000000000020202
020002000002202022222222020202
022202222220202020000002020202
000200000020202022222202020202
222222200220222002000002022002
200200200200002222222220020202
200000000222200200000020020222
202222222000202202200020020000
202000002000200200222020020202
222022002022202222202020022222
000220022020200000000020200002
000200020020222222222020200202
122220220020000020002020222202
000020200220022020222020200002
022220200020002000200020202222
020020222022202220222220202000
020000002000200020000000222220
020022202000220022220222200000
022020222222020200020000200020
002020200002022200020222202220
002020222202002002220200002000
222000000202000002000202022222
200022220202022222022202000002
222020022202002000000202222022
002020000002002000222200020020
002022222022202000200000020020
222002000020202020200222222220
200002022220002020200020000020
222222000022222022222220032220
