10
0100222222
0200200002
2202202222
2002002000
2222022220
0000020020
2202220022
2002000020
2222022220
0000020030
