18
222222222222222220
002000000002000200
202222222002000222
200020002002222002
200000002000002000
202222202222202221
202000200000200200
202200200220200200
200200200200202222
200202200200200202
202202002222220202
200202002000200002
222202222000000000
000200000002222222
320222222202000002
020000000202022202
022222222200020202
000020000222220222
