25
2222002022200002022221020
2002002020222222220000022
2000222220000000002222202
2200200020022222000200222
0222222000220202200220202
0000202220200000222000202
2222200020222220002020202
0200002020002020222222202
0222222002220020020020002
0200002220020222202222022
0222220022020000202002202
0020000002020220220000202
0020222222020200022200200
2220202000022200200222022
2002202222000220200200002
2022020000000022200222202
0020020222222000202000200
2220020200002022222002220
2020222220222000020222020
0020020020200222020200020
2220022000200202002220222
2000020022202202002020000
2022222020000002222020223
2220020020222200002020200
0000000022200222222022200
